19 12
    #####          
    #   #          
    #   #          
  ###   ##         
  #  p   #         
### # ## #   ######
#   # ## #####    #
#             p   #
##### ### # ##    #
    #     #########
    #######        